                              ####                                                                                   #### 
                              ####                                                                                   #### 
                              ####                                                                                   #### 
                              ####                                                                                   #### 
                              ########################################################################################### 
                              ########################################################################################### 
                              ########################################################################################### 
                              ########################################################################################### 
                              ########################################################################################### 
                              ########################################################################################### 
                              ########################################################################################### 
                              ########################################################################################### 
                              ########################################################################################### 
                              ####                                              ####                                 #### 
                              ####                                              ####                                 #### 
                              ####                                              ####                                 #### 
                              ####                                              ####                                 #### 
                                                                                #### 
                                                                                #### 
                                                                                #### 
                                                                                #### 
                                                                                #### 
                                                                                #### 
                                                                                #### 
                                                                                #### 
                                                                                #### 
                                                                                #### 
                                                                                #### 
                                                                                #### 
                              ####                                              ####                                 #### 
                              ####                                              ####                                 #### 
                              ####                                              ####                                 #### 
                              ####                                              ####                                 #### 
                              ########################################################################################### 
                              ########################################################################################### 
                              ########################################################################################### 
                              ########################################################################################### 
                              ########################################################################################### 
                              ########################################################################################### 
                              ########################################################################################### 
                              ########################################################################################### 
                              ########################################################################################### 
                              ####                                                                                   #### 
                              ####                                                                                   #### 
                              ####                                                                                   #### 
                              ####                                                                                   #### 
                                                                                                                          
                                                ################## 
                                           ############################ 
                                         ################################ 
                                       #################################### 
                                     ######################################## 
                                   ############################################ 
                                  ############################################## 
                                 #############         ####         ############# 
                                #########              ####              ######### 
                                #######                ####                ####### 
                               ######                  ####                  ###### 
                               #####                   ####                   ##### 
                              #####                    ####                    ##### 
                              ####                     ####                     #### 
                              ####                     ####                     #### 
                              ####                     ####                     #### 
                              ####                     ####                     #### 
                              ####                     ####                    ##### 
                               ###                     ####                   ##### 
                               ####                    ####                  ###### 
                                ###                    ####                ####### 
                                ####                   ####              ######### 
                                 ####                  ####         ############# 
                                  ####                 ######################### 
                                   #####               ######################## 
                                     #####             ###################### 
                                       ####            #################### 
                                                       ################## 
                                                       ################ 
                                                       ########### 
                                                                   
                              ####                                                                                   #### 
                              ####                                                                                   #### 
                              ########################################################################################### 
                              ########################################################################################### 
                              ########################################################################################### 
                              ########################################################################################### 
                              ########################################################################################### 
                              ########################################################################################### 
                              ########################################################################################### 
                              ########################################################################################### 
                              #### 
                              #### 
                                   
                              ####                                                                                   #### 
                              ####                                                                                   #### 
                              ########################################################################################### 
                              ########################################################################################### 
                              ########################################################################################### 
                              ########################################################################################### 
                              ########################################################################################### 
                              ########################################################################################### 
                              ########################################################################################### 
                              ########################################################################################### 
                              #### 
                              #### 
                                   
                                                ################## 
                                           ############################ 
                                         ################################ 
                                       #################################### 
                                     ######################################## 
                                   ############################################ 
                                  ############################################## 
                                 #############                      ############# 
                                #########                                ######### 
                                #######                                    ####### 
                               ######                                        ###### 
                               #####                                          ##### 
                              #####                                            ##### 
                              ####                                              #### 
                              ####                                              #### 
                              ####                                              #### 
                              ####                                              #### 
                              #####                                            ##### 
                              #####                                            ##### 
                               #####                                          ##### 
                               ######                                        ###### 
                                #######                                    ####### 
                                #########                                ######### 
                                 #############                      ############# 
                                  ############################################## 
                                   ############################################ 
                                     ######################################## 
                                       #################################### 
                                         ################################ 
                                           ############################ 
                                                ################## 
                                                                   
 
 
 
 
 
 
 
 
 
 
 
 
 
 
 
 
 
 
 
 
 
 
 
 
 
 
 
 
 
 
 
 
 
 
 
                                                                                                                     #### 
                                                                                                                     #### 
                                                                                                                     #### 
                                                                                                                     #### 
                                                                                                                   ###### 
                                                                                                              ########### 
                                                                                                         ################ 
                                                                                                     #################### 
                                                                                                ######################### 
                                                                                            ############################# 
                                                                                       ################################## 
                                                                                   ###################################### 
                                                                              ########################################### 
                                                                          ############################################### 
                                                                      ##########################################     #### 
                                                                 ##########################################          #### 
                                                            ###########################################              #### 
                                                        ########################################## 
                                                   ########################################## 
                                              ########################################### 
                                          ########################################### 
                                     ############################################ 
                                 ########################################### 
                              ########################################## 
                                 ################################## 
                                      ######################### 
                                          ################ 
                                               ############### 
                                                    ############### 
                                                         ############### 
                                                             ################ 
                                                                 ################# 
                                                            ########################### 
                                                        #################################### 
                                                   ########################################## 
                                              ########################################### 
                                          ########################################### 
                                     ############################################ 
                                 ########################################### 
                              ########################################## 
                                 ################################## 
                                      ######################### 
                                          ################ 
                                               ############### 
                                                    ############### 
                                                         ############### 
                                                             ################ 
                                                                  ################ 
                                                                       ################ 
                                                                            ################ 
                                                                                ################ 
                                                                                     ################                #### 
                                                                                          ################           #### 
                                                                                               ################      #### 
                                                                                                    ##################### 
                                                                                                         ################ 
                                                                                                              ########### 
                                                                                                                  ####### 
                                                                                                                     #### 
                                                                                                                     #### 
                                                                                                                     #### 
                                                                                                                     #### 
                                                                                                                          
                                                ################## 
                                           ############################ 
                                         ################################ 
                                       #################################### 
                                     ######################################## 
                                   ############################################ 
                                  ############################################## 
                                 #############                      ############# 
                                #########                                ######### 
                                #######                                    ####### 
                               ######                                        ###### 
                               #####                                          ##### 
                              #####                                            ##### 
                              ####                                              #### 
                              ####                                              #### 
                              ####                                              #### 
                              ####                                              #### 
                              #####                                            ##### 
                              #####                                            ##### 
                               #####                                          ##### 
                               ######                                        ###### 
                                #######                                    ####### 
                                #########                                ######### 
                                 #############                      ############# 
                                  ############################################## 
                                   ############################################ 
                                     ######################################## 
                                       #################################### 
                                         ################################ 
                                           ############################ 
                                                ################## 
                                                                   
                              ####                                              #### 
                              ####                                              #### 
                              ###################################################### 
                              ###################################################### 
                              ###################################################### 
                              ###################################################### 
                              ###################################################### 
                              ###################################################### 
                              ###################################################### 
                              ###################################################### 
                              ####                                  ###### 
                              ####                                    ###### 
                                                                       ####### 
                                                                        ####### 
                                                                         ####### 
                                                                          ####### 
                                                                          ######## 
                                                                           ######## 
                                                                           ######## 
                                                                     ############### 
                                                                   ################# 
                                                                  ################## 
                                                                 ################### 
                                                                 ################### 
                                                                 ################## 
                                                                 ################## 
                                                                  ################ 
                                                                   ############# 
                                                                     ######## 
                                                                              
                              ####                                                                                   #### 
                              ####                                                                                   #### 
                              ########################################################################################### 
                              ########################################################################################### 
                              ########################################################################################### 
                              ########################################################################################### 
                              ########################################################################################### 
                              ########################################################################################### 
                              ########################################################################################### 
                              ########################################################################################### 
                              #### 
                              #### 
                                   
                                              ###################### 
                                          ############################## 
                                       #################################### 
                                     ######################################## 
                                   ############################################ 
                                  ############################################## 
                                 ################################################ 
                                ###############                    ############### 
                               ###########                              ########### 
                               ########                                    ######## 
                              #######                                        ####### 
                              ######                                          ###### 
                              #####                                            ##### 
                              #####                                            ##### 
                              #####                                            ##### 
                               ####                                            #### 
                               #####                                          ##### 
                                #####                                        ##### 
                                 #####                                      ##### 
                                   #####                                  #####                                      #### 
                                     #####                              #####                                        #### 
                              ########################################################################################### 
                              ########################################################################################### 
                              ########################################################################################### 
                              ########################################################################################### 
                              ########################################################################################### 
                              ########################################################################################### 
                              ########################################################################################### 
                              ########################################################################################### 
                              #### 
                              #### 
                                   
